find https://www.youtube.com/playlist?list=PL7A4D9C100657150E
I Want You To Want Me - Vintage Blues Cheap Trick Cover ft. Sara Niemietz
Nothing Else Matters - Postmodern Jukebox ft. 15 Year Old Caroline Baran - Metallica Cover
Side To Side - 70s Soul Ariana Grande Cover ft. DeAndre Brackensick
What Is Love - Vintage 'Animal House' / Isley Brothers  - Style Cover ft. Casey Abrams
"Evolution Of Tap Dance" - Postmodern Jukebox ft. Sarah Reich
Poker Face - 1946 Big Band Style Lady Gaga Cover ft. Kelley Jakle
Bye Bye Bye - 2016 North American Postmodern Jukebox Tour Cast Version
Ain't No Rest For The Wicked - Vintage Jazz Cage The Elephant Cover ft. Joey Cook
Ice Ice Baby (w/ Ice Sculpture of Vanilla Ice) - Vintage Jazz Cover ft. Aubrey Logan
No Surprises - Vintage 1930s Jazz Radiohead Cover ft. Chloe Feoranzo
Colors of the Wind - Vintage '70s Soul Style Disney Cover ft. Mario Jose
Como La Flor - Postmodern Jukebox ft. Mayre Martinez-  Vintage Selena Tribute
Rather Be - Vintage Western / "Westworld" Saloon - Style Clean Bandit Cover ft. Ada Pasternak
Teenage Dirtbag - Vintage Janis Joplin Style Wheatus Cover ft. Jax
Mr. Brightside - 1940s Rat Pack Style The Killers Cover ft. Blake Lewis
Bizarre Love Triangle - Vintage Burt Bacharach - Style New Order Cover ft. Sarah Marie Young
Santeria - Vintage '40s Big Band Sublime Cover ft. Natalie Angst
Closer - Retro '50s Prom Style Chainsmokers / Halsey Cover ft. Kenton Chen
Don't Stop Me Now - Tina Turner Soul Style Queen Cover ft. Melinda Doolittle
This Love - Vintage 1940s Jazz Style Maroon 5 Cover ft. Devi-Ananda
Material Girl - Vintage 1920s Madonna Cover ft. Gunhild Carling
Since U Been Gone - Aretha Franklin - Style Soul Kelly Clarkson Cover ft. Mykal Kilgore
"Family Guy" Theme Song - Postmodern Jukebox ft. Casey Abrams &amp; Sarah Reich
Scars To Your Beautiful - Vintage Soul Alessia Cara Cover ft. Sara Niemietz
Cold Water - Vintage Bluegrass / Folk / Old Time Major Lazer Cover ft. Robyn Adele Anderson
Never Gonna Give You Up - Amazing Musical Virtuoso Gunhild Carling Plays Bagpipes, Trumpet &amp; more
Forget You - Vintage 1930s Cee Lo Cover ft. LaVance Colley
Heart Of Glass - Vintage '40s "Old Hollywood" Style Blondie Cover ft. Addie Hamilton
Don't Let Me Down - Vintage Gospel Soul Chainsmokers Cover ft. Rayvon Owen
I Will Survive - Vintage '40s Jazz / Latin Ballroom Style Cover ft. Sara Niemietz
Roxanne - Vintage '50 Rock'n' Roll Style Police Cover ft. Dani Armstrong
Can't Stop The Feeling - New Orleans Brass Band Justin Timberlake Cover ft. Aubrey Logan
Dream On - Postmodern Jukebox ft. Morgan James (Aerosmith Cover)
Toxic - Vintage 1930s Torch Song Britney Spears Cover ft. Melinda Doolittle
Dancing in the Dark - Retro '50s Style Bruce Springsteen Cover ft. Von Smith
You Give Love A Bad Name - Vintage Blues - Style Bon Jovi Cover ft. Jennie Lena
MMMbop (Doo Wop Version) - 1950s Style Postmodern Jukebox Hanson Cover
Black Hole Sun -  Vintage Soundgarden Cover ft. Haley Reinhart
Stressed Out - Postmodern Jukebox Twenty One Pilots Cover ft. Puddles Pity Party (Sad Clown)
Never Forget You - Vintage 1920s Gatsby Style Zara Larsson Cover ft. Addie Hamilton
Juicy - Vintage Jazz Notorious B.I.G. Cover ft. Maiya Sykes
Stone Cold - Postmodern Jukebox ft. Shoshana Bean
Pony - Vintage Jazz Ginuwine Cover ft. Ariana Savalas
Grenade - Vintage '60s Style Bruno Mars Cover ft. Brielle
Are You Gonna Be My Girl - Vintage Swing Jet Cover ft. Addie Hamilton
"Time After Time" Sung By 14 Year Old Caroline Baran - Postmodern Jukebox
Hollaback Girl - Vintage Swing Gwen Stefani Cover ft. Robyn Adele Anderson
Cry Me A River - Vintage '50s R&amp;B Justin Timberlake Cover ft. Von Smith
Ex's and Oh's - Vintage '30s Jazz Elle King Cover ft. Lisa Gary
Focus - Ray Charles Style Ariana Grande Cover ft. LaVance Colley
Same Old Love - Vintage New Orleans Selena Gomez Cover ft. Brielle Von Hugel
Hotline Bling - Vintage '40s Swing Drake Cover ft. Cristina Gatti
Sorry - Vintage Motown Justin Bieber Cover ft. Shoshana Bean
Bad Romance - Postmodern Jukebox: Reboxed ft. Sara Niemietz &amp; The Sole Sisters
Heroes - Postmodern Jukebox ft. Nicole Atkins - Bowie Cover  (from Heineken Advert)
Here - Peggy Lee - Style Postmodern Jukebox Alessia Cara Cover ft. Aubrey Logan
Love Yourself - Vintage 1929 Postmodern Jukebox Justin Bieber Cover ft. Sara Niemietz
Just Like Heaven - Vintage Glenn Miller - Style The Cure Cover ft. Natalie Angst
Bye Bye Bye - 60s "Pulp Fiction" Surf Rock Style *NSYNC Cover ft. Tara Louise
Thinking Out Loud - Vintage Swing Ed Sheeran Cover ft. Holly Campbell-Smith (#PMJsearch Winner!)
"The Tap Awakens" - 'Star Wars' Tap Dance Medley ft. Sarah Reich
Last Christmas - Vintage Andrews Sisters - Style Wham! Cover - Postmodern Jukebox
Ignition (remix) - Vintage Sinatra Style Swing R. Kelly Cover ft. Rayvon Owen
Hello - Vintage Soul '69 Adele Cover ft. Maiya Sykes
Mad World - Vintage Vaudeville - Style Cover ft. Puddles Pity Party &amp; Haley Reinhart
Say My Name - Vintage '60s Soul Ballad Destiny's Child Cover ft. Joey Cook
Thong Song - Vintage Louis Prima - Style Sisqo Cover ft. Blake Lewis
Welcome To The Jungle - Vintage Orchestral Guns 'n' Roses Cover ft. Daniela Andrade
Viva La Vida (from Super Bowl 50) - Sad Clown Style Coldplay Cover ft. Puddles Pity Party
Give It Away - '60s 'Austin Powers' - Style RHCP Cover ft. Aubrey Logan
Halo - Vintage Motown Style Beyonce Cover ft. LaVance Colley
Umbrella - Vintage "Singin' in the Rain" Style Rihanna Cover ft. Casey Abrams &amp; The Sole Sisters
Where Are U Now - Skrillex / Diplo / Justin Bieber Cover ft. Mykal Kilgore
Sugar, We're Going Down - Vintage Big Band - Style Fall Out Boy Cover ft. Joey Cook
Hey Ya! - Vintage '60s Soul Outkast Cover ft. Sara Niemietz
Single Ladies - Vintage "Chicago" / Fosse - Style Beyonce Cover ft. Ariana Savalas
Someday - 1941 "Casablanca"-style The Strokes Cover ft. Cristina Gatti
Lean On - '70s Stevie Wonder - Style Major Lazer Cover ft. Mykal Kilgore
Hey There Delilah - Vintage 1918 "World's Fair" Style Plain White T's Cover ft. Joey Cook
This Must Be The Place (Naive Melody) - Vintage 1940s Swing Talking Heads Cover ft. Sara Niemietz
My Heart Will Go On - Vintage '50s Jackie Wilson - Style Celine / Titanic Cover ft. Mykal Kilgore
Bad Blood - Vintage Ella Fitzgerald Jazz Taylor Swift Cover ft. Aubrey Logan - PMJ
Criminal - Vintage Torch Song Fiona Apple Cover ft. Ariana Savalas
I Kissed A Girl - Vintage '50s Doo Wop Katy Perry Cover ft. Robyn Adele Anderson
Oops!... I Did It Again - Vintage Marilyn Monroe Style Britney Spears Cover ft. Haley Reinhart
Incredible Tap Dancing Medley ft. Sarah Reich - Postmodern Jukebox
Boulevard of Broken Dreams - Soul Green Day Cover ft. Maiya Sykes
I Don't Mind - Vintage Las Vegas Style Usher Cover ft. Wilkie Ferguson
Radioactive - Vintage Jazz / Beatbox Imagine Dragons Cover ft. Blake Lewis
Lovefool - Vintage Jazz Cardigans Cover ft. Haley Reinhart
Bad Romance - Vintage 1920's Gatsby Style Lady Gaga Cover ft. Ariana Savalas &amp; Sarah Reich
Barbie Girl - Vintage Beach Boys - Style Aqua Cover ft. Morgan James
Style - 1959 "Grease"-Style Taylor Swift Cover ft. Annie Goodchild &amp; Von Smith
I Believe In A Thing Called Love - Vintage New Orleans-Style The Darkness Cover ft. Maiya Sykes
Paper Planes - Vintage 1940's Style MIA Cover ft. Robyn Adele Anderson
Creep - Vintage Postmodern Jukebox Radiohead Cover ft. Haley Reinhart
Poison - Vintage "Old Jack Swing" Bell Biv Devoe Cover ft. Shoshana Bean
All About That Bass - Postmodern Jukebox European Tour Version
Gangsta's Paradise - Vintage 1920's Al Capone Style Coolio Cover ft. Robyn Adele Anderson
Blank Space - Vintage Cabaret - Style Taylor Swift Cover ft. Ariana Savalas
